,0,1,2,3,4
0,-,-,-,0,E
1,-,-,-,0,-
2,-,-,-,0,-
3,-,-,-,0,-
4,-,-,-,0,-
