,0,1,2,3,4
0,-,-,-,-,-
1,-,-,-,-,-
2,-,-,-,0,-
3,-,-,-,0,-
4,0,-,-,0,-
